111111111111111111111111111111111111111111111111111111111111111
10000000000000000000000000000000000000C000000000000000000000001
10000P000000000000011111111100001111111111111110000000000000001
100000000000000000111111111100011111111111111111100000C00000001
100000000000000001111111111100011111111111111111110000000000001
100000000000000011111111111100011111110000011111110000000000001
1000000000000001111110111111000000000C0000011111110000000000001
100000000C000011111100111111000C0000000000011111110000000000001
100000000000011111100011111100000000000011111111100000000000001
100000000000111111111111111111000001111111111111000000000000001
100000000000111111111111111111000111111111111100000000000000001
10000000000011111111111111111100111111111110000000000C000000001
100000000000000000000011111100011111110000000000000000000000001
10000000000000000000001111110C011111110000000000000000000000001
100000000000000000000011111100011111110000000111111000000000001
100000000000000C00001111111111011111111111111111111000000000001
100000000000000000001111111111011111111111111111111000000000001
100000000000000000001111111111011111111111111111111000000000001
1000000000000000C000000000000000000000C0000000000000000000000E1
111111111111111111111111111111111111111111111111111111111111111