11111111111111111111111
10000000000000000000001
10000000C00C00C00000001
1000P0000000000000E0001
10000000C00C00C00000001
10000000000000000000001
11111111111111111111111